1111111111111111111111111111111111111111111111
1P00000000000000011C11C11111110000000000000001
100000000000000011001101CCCCC10000000000000001
1000000000000011000000000000010000000010100001
10000000000001110111110111111100000000101000C1
1000000000000000000011010000000000000010111111
10000000000000000000110001111100000000100000E1
1111111111111111111111111111111111111111111111