1111111111111111111111111111111111111111111111
100000100000000011C11C010000100000000000000001
100100100100000110011001CCCC100000000000000001
10010010010000110P0000000000100000000010100001
10010010010001110111100111111000000000101000C1
1001000001000000000110010000000000000010111111
10010000010000000001100001111100000000100000E1
1111111111111111111111111111111111111111111111