11111111111111111111111111111111111111111
10P100000000011C11C0100001000000000000001
100100100000110011001CCCC10000000X0X00001
10010010000110000000000001000000010100001
100100100011101111001111110000000101000C1
10000010000000001100100000000000010111111
100000100000000011000011111000000100000E1
11111111111111111111111111111111111111111