11111111111111111111111111111111
100000000000000000000000X000CX01
101010101010101010101010100XCX01
101010101010101010101010100XCX01
1C101010101010101010101010111111
111X1010101010101010101010111111
1E00000000000000P000000000111111
111X1010101010101010101010111111
1C101010101010101010101010111111
101010101010101010101010100XC001
1010101010101010101010101000C001
100000X0000000X000000000000XC001
11111111111111111111111111111111