11111111111111111111111111111111
1000000000000000000000000000C001
1010101010101010101010101000C001
1010101010101010101010101000C001
10101010101010101010101010111111
10101010101010101010101010111111
E000000000000000P000000000111111
10101010101010101010101010111111
10101010101010101010101010111111
1010101010101010101010101000C001
1010101010101010101010101000C001
1000000000000000000000000000C001
11111111111111111111111111111111
