11111111111111111111111111111111
1000000000000000000000000000C001
1010101010101010101010101000C001
1010101010101010101010101000C001
1C101010101010101010101010111111
11101010101010101010101010111111
1E00000000000000P000000000111111
11101010101010101010101010111111
1C101010101010101010101010111111
1010101010101010101010101000C001
1010101010101010101010101000C001
1000000000000000000000000000C001
11111111111111111111111111111111
