10110111000001110100111010000011010111011101
00110110110111001001111000001100010000110000
01000111010110110001011000011001001101100011
00010011101000111001001010100001100101100101
10001111000000101110110100001001000000110111
01011000010100110100000111011000001111100001
00000001100110110000100000100100010111010010
01011001111100100110000000110101110011011111
01110001001011100100001000110110101010110011
10011100001011101100001110101010101100010001
00010101000100001101010111000001000001101010
01010010101001011101111101100000011101111011
10000001001100001010110101001000011110011011
10100101001100000100000101000110100000011101
11100100001010110111001101111110111100010100
00110000111110100110100000010010110001100100
11001000101101110110001110111000001010000100
00001111101100101010111101000010100110100110
11001000000100010110011101111000011101000011
10110010010010100000111101000100000101001111