1111111111111111111111111111111111
1E0000000000000C00X00C000000000001
1010010100100X00101001000000010101
1010010010101010001001000000010101
1P000000XCX0CX00000000000001111111
1111111111111111111111111111111111