1111111111111111111111111111111111111111111111111111111111111111111
10P0100100111101011011011010101000010101010011000111000011100110111
1101110110011000000001101101101110110100101100100110101010101110101
1000000110110011100001101001100100110010101011100100000111011010011
1000001010001001111011100C00101100001010111001100010C01100011100011
1000011010001110101001011000111001001110000000101110110011110001111
1010110011100100001011110110110011001010010010110101011001111010101
1000111110110000011011110100101000011100000001011010001110101000101
1101100010110010111101001111000100011010111111001110010001010011101
1101101111001110110001000010100101101100111101100010111111000011011
1101101010111010111010011000110010010001100001011111100001111000111
1000101101010100110010001110111010101100011110010100010111000000101
1100110111110000001101111110110001110011100101101011010110101000011
11100010110100111101110000001001111111100000C0010011000000010101001
1001101101110010110000001010011110110100111100100101011000001011101
1011100011101100011010100100000011100100101110111000011011100110101
1101000100000011100000001010010111111100010110010101010011000001111
1110000110011100001000110001000100111110011010010100010011110111011
1100110000000001111001110011110101010100111110101001100011010011111
1001000010100110001010101111100101010110000010000011011101000011101
10111011000010111011010100000000000000000001111111100100101100000E1
1001111101001110111110001101110111101011010111010111000111101111101
1111111111111111111111111111111111111111111111111111111111111111111