111111111111111111111111111111111111111111111111111111111111111111111111111111111111111111111111
10P000010000000000000C0000000000000000000000000100000000100000010000001000001000000000000100C001
100000010000001000001C000000000000000000000000010000000010000001000000100C0010000000000001000001
1000000100000C0000001111111111111111111100000001000000001000000100000010000010000001111111000001
100000010000000000001000000000000000000000000001000000001000000100000010000010000000000001000001
100000010000000000001000000000000000000000000001000000001000000100000010000010000000000000000001
100000010000000000001000000000000000000000000001000000000000000100000010000010000000000001000001
100000010000000000001000C00000000000000000000001000000001000000100000010000010000000000001000001
100000010000000000001000000000010XX0111111000001000000001000000100000010000010000000000001000001
100000010000000000001000000100010000100000000001000000001000000000000010000010000000000001000001
10000001111111111110100000010001000010000X000001000000001000000100000010000011101111000001000001
10000000000000000000100000010001000010000X000001000000001000000100000010000010000001000001000001
10000000000000000000100000010001000C1C0000000001000000001000000100000010000010000001000000000001
100000000000000000001000000100011111111111000001000000001000000100000010000010000001000001000001
10000000000000000000100000010000000C1C0001000001000000001000000100000010000010000001000001000001
1000000000000000000010000001000X0000100001000001000000001000000100000010000010000001000001000001
1000000000000000000010000001000X0000100001000001000000001000000100000010000000000001000001000001
111111111111100000001000000100000000100001000001000000001000000100000010000000000001000001000001
10000000000000000000100000010001111110XX01000000000000001000000100000010000000000001000000000001
100000000000000000001000000100000000000000000000000000001000000100000010000000000001000100000001
100000000000000000001000000100000010000000000000000000001000000100000010000000000001000100000001
100000000000000000001000000100000010000000000000000000001000000100000010000000000001000100000001
100000000000000000001000000100000010000000000000000000001000000100000010000000000001000100000E01
111111111111111111111111111111111111111111111111111111111111111111111111111111111111111111111111