1111111111111111111111111111111111111111111111111111111111111111111
10P0100100111101011011011010101000010101010011000111000011100110111
1101110110011000000001101101101110110100101100100110101010101110101
1000000110110011100001101001100000110010101011100100000001011010011
1000001010001001111011100C00001100001010111001100010C01100000100011
1000000010001110101001011000111001001110000000101110110011110001111
1011100011101100011010100000000011100000101110111000011011100110101
1101000100000011100000001010010111111100010110010101010011000001111
1110000110011100001000110001000100111110011010010100010011110111011
1100110000000001111001110011110101010100111110100001100011010011111
1001000010100110001010101111100101010110000000000011011101000011101
10111011000000001011010100000000000000000001111111100100101100000E1
1111111111111111111111111111111111111111111111111111111111111111111