11111
1EC01
10001
100P1
10001
11111