11111111111111111
1E000000000000P01
10000XXXX0X000001
10000X0C00X000001
11111111111111111