11111111111111111
1E000000000000P01
10000000000000001
1000000C000000000
11111111111111111